[greetings]
hi; bye (informal)     =       안녕
hello = 안녕하 세요
goodbye (standard, to person leaving) = 안녕히 가세요
goodbye (standard, you are leaving) = 안녕히 계세요

[countries]
USA=미국
China=중국
Japan=일본
India=인도
Australia=호주
UK=영국
Germany=독일
France=프랑스
Canada=캐나다
Korea=한국
Russia=라시아

[occupations]
teacher=선생님
student=한생
doctor=의사
chef=요리사
bank clerk=은행원
reporter=기자
company employee=회시원
researcher=연구원

[identity]
here=여기
mr, miss, mrs, ms=시
I=저
this person (older, higher position)=이분
person=사람
name=이름
nationality=국적
job/occupation=직업
address=주소
telephone=전화

[food]
food=음식
noodles=국수
bread=빵
pasta=파스타
rice=밥
potato=감자
vegetable=채소
fruit=과일
meat=고기
samgyetang=삼계탕
apple=사과
orange=오렌지
lemon=레몬
snack=간식
bulgogi=불고기
soup=수프
egg=달걀
cheese=치즈
chicken (meat)=닭고기
pork=돼지고기
beef=소고기
fish=생선
water=물
coffee=커피
tea=차
beer=맥주
wine=와얀
milk=우유
juice=주스
sauce=소스
cooking oil=오일
sesame oil=참기름
butter=버터
bibimbap = 비빔밥
pork bone soup = 감자탕
banana = 바나나
kimchi=김치
hamburger=햄버거
naengmyeon=냉면
gimbap=김밥
cola=콜라
black tea=홍차
green tea=녹차

[numbers]
one=하나
two=둘
three=셋
four=넷
five=다섯
six=여섯
seven=일곱
eight=여덟
nine=아홉
ten=열
one (ch)=일
two (ch)=이
three (ch)=삼
four (ch)=사
five (ch)=요
six (ch)=육
seven (ch)=칠
eight (ch)=팔
nine (ch)=구
ten (ch)=십
hundred=백
thousand=천
ten thousand=만
hundred thousand=십만

[demonstratives]
this=이거
that (2nd person)=그거
that (3rd person)=저거

[store objects]
watch/clock=시계
umbrella=우산
ball-point pen=볼펜
cell phone=휴대 전화
cigarette=담배
Korean (language)=한국어
dictionary=사전
newspaper=신문
bag=가방
camera=카메라
skirt=치마
pencil=연필
book=책
hat=모자
dress shoes=구두
pants=바지
notebook=공책
money=돈

[verbs]
to to give=주다
to go=가다
to sit down=앉다
to rest=쉬다
to read=얽다
to come=오다
to wait=기다리다
to write=쓰다
to have=있다
not to have=없다
how much?=얼마
KRW, won=원
then/in that case=그럼

[good shit]
shut up = 닥쳐
this is fucked up = 좆같네
you dumbass = 병신아
slut, hoe, whore = 창녀
vagina = 보지
bullshit = 지랄하네
fucking good = 졸라 좋아
